R 100 300

NO ./textures/bricks2.xpm
SO ./textures/faces.xpm
WE ./textures/wall.xpm
EA ./textures/wall2.xpm
S ./textures/sunflower.xpm

F 220,100,0
C 225,30,0

11111111111111111111111111111111111111111111111111111111111111111111111111111111
10000000000000000000000000000000000000000000000000000000000000000000000000000011
10000000000000000000000000000000000000000000000000000000000000000000000000000011
1000000000000000000000000000001111111111111111111000000000000000000000000000011
1000000000022222222222222222222222222222220000000000000000000000000000000000011
10001000000000000000000000000000000000000000000000000000000000000000000000000011
1000000000002222222222222222000000E00111111111111000000000000000000000000000011
10001000000000000000000000000000000000000000000000000000000000000000000000000011
1000000000002222222222222222222000000000000000000000000000000000000000000000011
10000000000000000000000000000011111111111111111110000000000000000000000000000011
10000000000000000000000000000000000000000000000000000000000000000000000000000011
10000000000000000000000000000000000000000000000000000000000000000000000000000011
10000000000000000000000000000000000000000000000000000000000000000000000000000001
11111111111111111111111111111111111111111111111111111111111111111111111111111111