R 1000 1000


NO ./NO.xpm
SO ./SO.xpm
WE ./path_to_the_west_texture
EA ./path_to_the_east_texture
S ./path_to_the_sprite_texture


F 220,100,0
C 225,30,0


 11111111111111                                           
 10000000000001                                           
 10000000000000111111111                                  
 11110000000000000000001             
     1000000000001111111                                  
     100000000001                                         
     100000000001     111111                              
      1111111000011111100001  111    111    1   1   1  1  
     11111111000000000000001  1  1   1  1   1   1   1  1  
             11100000000000000111111    1111   1   1   1111                        
                1100000N000000001  1  1   1  1   1   1   1  1  
   11111111000000000000000111111111  1111111111111  1
   1000000000000000000000001
   111111111111111111111111
       
   11111               1111111
   111111111111111111111111111111 
   1111110000000000000000111111111111111           
   1000000000000000000000001                             
   1000000111111111111110011                              
   10000001            10001                                    
   1000000011111111    100001                             
   10000000000000011111111101                             
    1111111111111000000000001                             
                 11111100111                              
                      1001                                
              111     1001                                
             1000111111001                                
             1000000001111                                
             100011111                                    
              111                                 