R 1200  800

NO ./textures/bricks2.xpm
SO ./textures/faces.xpm
WE ./textures/wall.xpm
EA ./textures/wall2.xpm
S ./textures/barrel.xpm

F 220,100,0
C 255,30,2

111111111111111111111111111111111111111111111111
1000000000000222222222200000000000000000000000001
100000000000000000000000000000000000000000N00001
1000000000000000000000000000000000000000000000001
111111111111111111111111111111111111111111111111