R 1000 1000


NO ./textures/bricks2.xpm
SO ./textures/faces.xpm
WE ./textures/wall.xpm
EA ./textures/wall2.xpm
S ./textures/daisy.xpm


F 220,100,0
C 225,30,0


 11111111111111                                     1111111111111      
 10000000000001                                     100000000000011111111111111   
 100000000000001111111111111111                     111111111000000000000000001
 1111000001111100000000000001                            1000010000000111111111
     100000000000111111001111111                      11110000000000001
     100000011111      1000001                       10000000000001111111                       
     100000000001    100000001               11111111100000000000000000001     
     110000000011    11000011               1000000000000000000111111111111
      111000000011111100001                 11111111111111111111         
     1111111100000000000000111             
             1110000000000000011           
         11111110000000N000000001                                               
   11111110000000000000000001111              
   1000000000000000000000001                         
   111111111111111111111111                        