R 1000 700

NO ./textures/bricks2.xpm
SO ./textures/faces.xpm
WE ./textures/wall.xpm
EA ./textures/wall2.xpm
S ./textures/sunflower.xpm

F 220,100,0
C 225,30,0

11111111111111111111111111111111111111111111111111111111111111111111111111111111
10000000000000000000000000000000000000000000000000000000000000000000000000000011
10000000000000000000000000000000000000000000000000000000000000000000000000000011
1000000000000000000000000000001111111111111111111000000000000000000000000000011
10000000000044444444444444440000000000000000000000000000000000000000000000000011
10001000000000000000000000000000000000000000000000000000000000000000000000000011
1000000000002222222222222222000000E00111111111111000000000000000000000000000011
10001000000000000000000000000000000000000000000000000000000000000000000000000011
10000000000033333333333333330000000000000000000000000000000000000000000000000011
10000000000000000000000000000011111111111111111110000000000000000004000000000011
10000000000000000000000000000000000000000000000000000000000000000000000000000011
10000000000000000000000000000000000000000000000000000000300000000000000000000011
10000000000000000000000000000000000000000000000000000000000000000000000000000001
11111111111111111111111111111111111111111111111111111111111111111111111111111111